########################################
#                  X#S                 #
# ################################### ##
#P                   #    P            #
# ################## ########### #######
#                A#                P   #
########################################